111111
1P10C1
100001
101E01
111111